9,9

#########
#@      #
#     $ #
#### $  #
#..#    #
#..# $  #
# $ $   #
#..$    #
#########
