11,11

###########
#.*.#..   #
#  .#.. $ #
#   #   $ #
#  $#@    #
# $ $  $  #
#  $    $ #
#.   $    #
#####     #
#.*   $ *.#
###########
