12,12

############
#@ .#..    #
#  .#..  $ #
#   #.#  $ #
#   ###  $ #
# $ $      #
# $ $ $ $  #
#########  #
#..        #
###.   $   #
#..    $ $ #
############
