14,14

##############
#@   #...... #
# $$ #...*.. #
# $  #..###  #
# $  ####.#  #
#            #
# $$$$#      #
#     #      #
#######  $   #
#    ##..#$  #
# $$$ ####   #
#   $  $ $   #
#            #
##############
